Rank ,Name,Math,Physics,Chemistry,Total
1,Lalit goud,95,80,95,270
2,Bhavani,95,81,93,269
3,Nikhil,93,80,95,268
4,Priya,91,87,89,267
5,Bharat,89,89,88,266
6,Jaswitha,87,89,88,264
7,Sai,88,86,87,261
8,Pooja,85,85,86,256
9,Kaushik,81,82,81,244
10,Vinay,80,80,81,241